40x40
1111111111111111111111111111111111111111
1000000000000000000000000000000000000001
1000000000000000000000000000000000000001
1000000000000000000000000000000000000001
1000000000000000101000000000001010000001
1000000000000000101000000000001010000001
1000000000000000101000000000001010000001
1000000000000000101000000000001010000001
1000000000000000101000000000001010000001
1000000000000000101000000000001011111111
1000000111111111000111111110000000000001
1000000000000000000000000000000011111111
1000000111111111000111111110000000000001
1000000000000000101000000000000000000001
1000000000000000101000000000000000000001
1000000000000000101000000000000000000001
1000000000000000101000000000000000000001
1000000000000000000000000000000000000001
1000000000000000000000000000000000000001
1000000000000000000000000000000000000001
1000000000000000000000000000000000000001
1000000000000000000000000000000000000001
1000000000000000000000000000000000000001
1000000000000000001000000000000000000001
1000000010000000000S00000000000000000001
1000000010000000010000000000000000000001
1000000000000000000000000000000000000001
1000000000000000000000000000000000000001
1000000000000000000000000000000000000001
1000000000000000000000000000000000000001
1000000000000000000000000000000000000001
1000000000000000000000000000000000000001
1000000000000000000000000000000000000001
1000000000000000000000000000000000000001
1000000000000000000000000000000000000001
1000000000000000000000000000000000000001
1000000000000000000000000000000000000001
1000000000000000000000000000000000000001
1000000000000000000000000000000000000001
1111111111111111111111111111111111111111
