10x10
1111111111
1000000001
1010001001
1000000001
1010000001
1001000001
1010000S01
1000000001
1010001001
1111111111
