10x10
1111111111
1000000001
1000000001
1000000001
1000000001
1000000001
1000000S01
1000000001
1000000001
1111111111
