10x10
1111111111
1000000001
1000000001
1000000001
1000101001
1111101111
10000S0001
1111101111
1000101001
1111111111
