10x10
1111111111
1000000001
1000000001
1000000001
1000000001
1000000001
1001110001
110000S001
1010000001
1111111111
