10x10
1111111111
1000000001
1000000001
1000000001
1000101001
1001101001
10100S0011
1100000001
1000010001
1111111111
